pkt	skrs
dca	skrs
z-ca	skrs
oo.	skrs
pp.	skrs
ss.	skrs
abp	skrs
arcybp	skrs
b-cia	skrs
bp	skrs
dr	skrs
f-ka	skrs
f-ma	skrs
kmdr	skrs
kmdt	skrs
m-c	skrs
mgr	skrs
mjr	skrs
nr	skrs
płk	skrs
ppłk	skrs
r-k	skrs
śś.	skrs
W-wa	skrs
Z-dy	skrs
s-ka	skrs
ss.	skrs
adw.	skrl
afg.	skrl
afr.	skrl
alb.	skrl
alf.	skrl
alg.	skrl
alp.	skrl
am.	skrl
amb.	skrl
ang.-am.	skrl
anglik.	skrl
anglos.	skrl
ap.	skrl
Apok.	skrw
ar.	skrl
as.	skrl
astr.	skrl
astrol.	skrl
asyr.	skrl
atom.	skrl
att.	skrl
austr.	skrl
austral.	skrl
azerb.	skrl
azj.	skrl
azt.	skrl
babil.	skrl
bak.	skrl
bałk.	skrl
bałt.	skrl
bank.	skrl
bar.	skrl
bask.	skrl
berlin.	skrl
baszk.	skrl
baw.	skrl
b-cia	skrl
bdb.	skrf
beatyf.	skrl
belg.	skrl
beng.	skrl
białorus.	skrl
biograf.	skrl
birm.	skrl
bizant.	skrl
braz.	skrl
bret.	skrl
bryt.	skrl
bułg.	skrl
burg.	skrl
cel.	skrl
celt.	skrl
chiń.	skrl
chopin.	skrl
chorw.	skrl
chrz.	skrl
csł.	skrl
cybern.	skrl
cyg.	skrl
cypr.	skrl
czechosłow.	skrl
czes.	skrl
czw.	skrl
czyt.	skrw
ćwicz.	skrl
db.	skrl
dcn.	skrw
dent.	skrl
dm	skrl
dor.	skrl
dost.	skrl
dow.	skrl
duń.	skrl
dz.	skrl
dziek.	skrl
edyn.	skrl
egip.	skrl
ekol.	skrl
ekon.	skrl
encykl.	skrl
esper.	skrl
est.	skrl
etiop.	skrl
etr.	skrl
ew.	skrl
ewang.	skrl
fel.	skrl
fil.	skrl
filip.	skrl
filoz.	skrl
fiń.	skrl
flam.	skrl
flor.	skrl
franc.	skrl
frank.	skrl
fund.	skrl
galic.	skrl
Gen.	skrw
germ.	skrl
gim.	skrl
gł.	skrl
gosp.	skrl
gr.	skrl
graf.	skrl
gram.	skrl
greg.	skrl
grn.	skrl
gruz.	skrl
gwar.	skrl
harc.	skrl
hawaj.	skrl
hebr.	skrl
hels.	skrl
hetm.	skrl
hind.	skrl
hist.	skrl
hiszp.	skrl
hm.	skrl
hol.	skrl
hondur.	skrl
hrab.	skrl
huc.	skrl
huf.	skrl
hus.	skrl
ie.	skrl
i in.	skrw
ikon.	skrl
infl.	skrl
instr.	skrl
irań.	skrl
irl.	skrl
iron.	skrl
isl.	skrl
it	skrw
izrael.	skrl
j.	skrl
jak.	skrl
jap.	skrl
jawaj.	skrl
JCM	skrf
JCW	skrf
JE	skrw
jerozol.	skrl
jid.	skrl
JKM	skrf
JKW	skrf
JM	skrf
jn.	skrw
jp.	skrw
jugosł.	skrl
k.	skrw
kanad.	skrl
kanc.	skrl
kanoniz.	skrl
karaib.	skrl
katol.	skrl
khmer.	skrl
kirgis.	skrl
kmdr	skrl
kmdt	skrl
kong.	skrl
kongr.	skrl
kośc.	skrl
kr	skrl
k.tyt.	skrl
kub.	skrl
kult.	skrl
kurd.	skrl
kuw.	skrl
lab.	skrl
laot.	skrl
lic.	skrl
lingw.	skrl
lioń.	skrl
lir.	skrl
lit.	skrl
lizb.	skrl
łot.	skrl
m.	skrl
maced.	skrl
magnet.	skrl
mahom.	skrl
maks.	skrl
malt.	skrl
mat.	skrl
meteor.	skrl
międzynar.	skrl
międzywoj.	skrl
mit.	skrl
mołd.	skrl
modern.	skrl
Mon.	skrl
mong.	skrl
opr.	skrl
muzełum.	skrl
n.	skrw
nad.	skrl
podst.	skrl
nar.	skrl
nauk.	skrl
nazw.	skrl
ndst.	skrl
neoklas.	skrl
ngr.	skrl
niderl.	skrl
niedz.	skrl
NMP	skrf
nord.	skrl
norw.	skrl
not.	skrl
nowoż.	skrl
nw.	skrw
odc.	skrl
oddz.	skrl
odp.	skrl
og.	skrl
ogł.	skrl
ogp.	skrl
org.	skrl
orient.	skrl
orm.	skrl
oryg.	skrl
Oss.	skrw
paleont.	skrl
palest.	skrl
pant.	skrl
panc.	skrl
pap.	skrl
parl.	skrl
part.	skrl
pers.	skrl
peruw.	skrl
piąt.	skrl
pie.	skrl
płd.-zach.	skrl
płn.-wsch.	skrl
pn.-zach.	skrl
płw.	skrl
podchor.	skrl
podr.	skrl
podof.	skrl
polit.	skrl
popr.	skrl
porad.	skrl
port.	skrl
pośm.	skrl
ppoż.	skrl
prasł.	skrl
prehist.	skrl
prowans.	skrl
przykł.	skrl
przysł.	skrl
rach.	skrl
radz.	skrl
rec.	skrl
reg.	skrl
rej.	skrl
rel.	skrl
rep.	skrl
repr.	skrl
rew.	skrl
rum.	skrl
rus.	skrl
rz.-kat.	skrl
sam.	skrl
sas.	skrl
saud.	skrl
s.c.	skrf
sch.	skrl
sejm.	skrl
sem.	skrl
serb.	skrl
skand.	skrl
sł.	skrl
słow.	skrl
słow.	skrl
słń.	skrl
słowiń.	skrl
sob.	skrl
społ.	skrl
sp. z o.o.	skrw
S.T.	skrl
stom.	skrl
stpol.	skrl
strz.	skrl
syr.	skrl
szk.	skrl
SzSz	skrl
szw.	skrl
szwajc.	skrl
śl.	skrl
śr.	skrl
średn.	skrl
środ.	skrl
śś.	skrw
świat.	skrl
świec.	skrl
teatr.	skrl
telef.	skrl
temp.	skrl
teol.	skrl
teoret.	skrl
tm.	skrw
tryb.	skrl
tur.	skrl
tydz.	skrl
tyt.	skrl
ucz.	skrl
uk.	skrl
ukr.	skrl
urz.	skrl
UWil	skrl
UWr	skrl
wal.	skrl
war.	skrl
wet.	skrl
węg.	skrl
W-wa	skrl
wydz.	skrl
wyj.	skrl
wym.	skrl
x.	skrl
zag.	skrl
zagr.	skrl
zak.	skrl
zal.	skrl
zam.	skrl
zapł.	skrl
zast.	skrl
zat.	skrl
zaw.	skrl
z-ca	skrl
zeg.	skrl
zewn.	skrl
zn.	skrl
zoo	skrl
o.o.	skrw
ZP	skrl
up.	skrw
z wyj.	skrw
wył.	skrw
ż.	skrl
żart.	skrl
żołn.	skrl
żyd.	skrl
żyw.	skrl
alegor.	skrl
aram.	skrl
barok.	skrl
brajl.	skrl
c	skrl
c.	skrl
CHF	skrl
chil.	skrl
chł.	skrl
d.	skrl
dram.	skrl
dziec.	skrl
dzis.	skrl
esk.	skrl
euf.	skrl
eur.	skrl
F	skrl
faszyst.	skrl
hitl.	skrl
i.	skrl
wyr.	skrl
indian.	skrl
k.	skrl
kol.	skrl
kontradm.	skrl
kus.	skrl
l.	skrl
malaj.	skrl
m-c	skrl
meks.	skrl
nadinsp.	skrl
nadzw.	skrl
neapol.	skrl
nłc.	skrl
NN	skrl
ogsł.	skrl
osm.	skrl
osm.-tur.	skrl
paraf.	skrl
pgr.	skrl
PLN	skrf
płac.	skrl
podkom.	skrl
post.	skrl
PP	skrf
prawosł.	skrl
przegl.	skrl
renes.	skrl
r-k	skrl
romant.	skrl
rzym.	skrl
s.	skrl
staroż.	skrl
tat.	skrl
kom.	skrl
urugw.	skrl
wenez.	skrl
wietn.	skrl
wsp.	skrl
wz.	skrl
z.	skrl
ZN	skrl
mrn.	skrl
b.	skrl
habil.	skrl
tab.	skrl
nlb.	skrl
ob.	skrl
prob.	skrl
zob.	skrw
ub.	skrl
wyb.	skrl
łac.	skrl
oproc.	skrl
mec.	skrl
ppanc.	skrl
doc.	skrl
proc.	skrl
sześc.	skrl
ryc.	skrl
d.	skrl
wiad.	skrl
cd.	skrw
med.	skrl
red.	skrl
zesz.	skrl
płd.	skrl
kand.	skrl
kard.	skrl
itd.	skrw
wyd.	skrw
n.e.	skrw
p.n.e.	skrw
ref.	skrl
prof.	skrl
bryg.	skrw
tyg.	skrl
Ch.	skrl
zach.	skrl
wsch.	skrl
obj.	skrl
zdj.	skrl
poj.	skrl
woj.	skrl
tj.	skrw
lek.	skrl
sek.	skrl
Wlk.	skrl
ok.	skrw
dok.	skrl
prok.	skrl
ark.	skrl
osk.	skrl
tabl.	skrw
tel.	skrl
kl.	skrl
dol.	skrl
kol.	skrl
pol.	skrl
pl.	skrl
dypl.	skrl
ul.	skrl
Biul.	skrw
zał.	skrl
bł.	skrl
dł.	skrl
przeł.	skrl
mł.	skrl
ppł.	skrl
tł.	skrw
wł.	skrl
n.p.m.	skrw
p.p.m.	skrw
Pam.	skrl
bm.	skrw
kadm.	skrl
ndm.	skrl
niem.	skrl
gm.	skrl
im.	skrw
nadkom.	skrl
rtm.	skrl
tłum.	skrw
zm.	skrw
n.	skrl
kan.	skrl
dn.	skrw
cdn.	skrw
Zjedn.	skrl
gen.	skrl
sen.	skrl
sygn.	skrl
techn.	skrl
in.	skrl
m.in.	skrw
min	skrl
wicemin.	skrl
płn.	skrl
mn.	skrl
nn.	skrw
hon.	skrw
Kron.	skrw
pn.	skrl
pn.	skrl
tzn.	skrw
o.	skrl
o.o.	skrl
p.o.	skrf
oo.	skrw
p.	skrw
błp.	skrw
np.	skrw
pp.	skrl
sp.	skrl
insp.	skrl
podinsp.	skrl
śp.	skrw
itp.	skrf
przyp.	skrl
r.	skrl
mar.	skrl
par.	skrl
br.	skrw
rubr.	skrl
szer.	skrl
geogr.	skrl
margr.	skrl
hr.	skrl
sekr.	skrl
skr.	skrl
SJPDor.	skrl
chor.	skrl
pchor.	skrl
por.	skrl
ppor.	skrl
pr.	skrl
Pr.	skrw
kpr.	skrl
współpr.	skrl
str.	skrl
ur.	skrl
dyr.	skrl
s.	skrl
ds.	skrw
Przeds.	skrl
mies.	skrl
mies.	skrl
ks.	skrl
os.	skrl
pos.	skrl
ros.	skrl
ss.	skrl
rys.	skrl
tys.	skrl
wys.	skrl
t	skrl
gat.	skrl
nt.	skrw
fot.	skrw
pt.	skrw
kpt.	skrl
kwart.	skrl
nast.	skrl
podst.	skrl
poczt.	skrl
szt.	skrl
Dz.U.	skrf
w.	skrl
spraw.	skrl
ew.	skrw
dew.	skrl
wew.	skrl
przew.	skrl
jw.	skrw
kw.	skrl
pow.	skrl
stow.	skrl
pw.	skrw
św.	skrl
ww.	skrw
dyw.	skrl
zw.	skrl
tzw.	skrf
gaz.	skrl
nacz.	skrl
pocz.	skrl
Rocz.	skrl
codz.	skrw
godz.	skrl
rodz.	skrl
rozdz.	skrl
rez.	skrw
prez.	skrl
egz.	skrl
poz.	skrl
Przegl.	skrl
Zrzesz.	skrl
marsz.	skrl
reż.	skrl
inż.	skrl
sierż.	skrl
Ba	skrw
Ga	skrw
ha	skrl
f-ka	skrl
ska	skrl
f-ma	skrl
Na	skrw
Za	skrw
Ab	skrw
Lb	skrw
C	skrw
mld	skrl
USD	skrl
Jud	skrw
Ezd	skrw
Ne	skrw
Ag	skrw
kg	skrl
dkg	skrl
mg	skrl
wg	skrw
Mch	skrw
Koh	skrw
Hi	skrw
Mi	skrw
GW	skrf
JW	skrf
J	skrw
Wj	skrw
ndk	skrl
Jk	skrw
Łk	skrw
płk	skrl
ppłk	skrl
Mk	skrw
dcl	skrl
dl	skrl
hl	skrl
Jl	skrw
dkl	skrl
ml	skrl
Kol	skrw
PL	skrw
v.	skrl
Krl	skrw
Kpł	skrw
zł	skrl
Am	skrw
DEM	skrl
km	skrl
c	skrw
dkm	skrl
Lm	skrw
Flm	skrw
mm	skrl
Ps	skrw
Jdt	skrw
pkt	skrl
Mt	skrw
NT	skrf
Rut	skrw
Est	skrw
Sm	skrw
Tm	skrw
Dn	skrw
min.	skrl
mln	skrl
Jon	skrw
Krn	skrw
So	skrw
P	skrw
Ap	skrw
bp	skrl
abp	skrl
SJP	skrl
Flp	skrw
P.n.P.	skrw
Hbr	skrw
dr	skrl
Mdr	skrw
gr	skrl
mgr	skrl
Jr	skrw
mjr	skrl
nr	skrl
Kor	skrw
Syr	skrw
Tes	skrw
Tt	skrw
Pwt	skrw
Z-dy	skrl
Dz	skrw
Rdz	skrw
Sdz	skrw
Ez	skrw
MHz	skrl
Iz	skrw
Joz.	skrw
Rz	skrw
Prz	skrw
GŻ	skrl
a	skrl
s	skrl
l	skrl
cm	skrl
g	skrl
Kl	skrw
Neh	skrw
Job	skrw
Jan	skrw
Kazn.	skrw
Jer.	skrw
Eze	skrw
Oz	skrw
Nah	skrw
Ha	skrw
Hab	skrw
Sof	skrw
Ml	skrw
Mal	skrw
Gal	skrw
Ef	skrw
Hebr.	skrw
Jak	skrw
Obj.	skrw
dal	skrl
dam	skrl
akc.	skrl
arch.	skrl
arch.	skrl
arc.	skrl
bar.	skrl
SO	skrl
CC	skrl
cz.	skrl
czyt.	skrl
d.	skrl
d.	skrl
dial.	skrl
dop.	skrl
dow.	skrl
dypl.	skrl
egz.	skrl
Ew	skrl
fen.	skrl
flor.	skrl
got.	skrl
hon.	skrl
hus.	skrl
ind.	skrl
instr.	skrl
kal.	skrl
kol.	skrl
kom.	skrl
kom.	skrl
księg.	skrl
kult.	skrl
lic.	skrl
lit.	skrl
lic.	skrl
lit.	skrl
magnet.	skrl
mat.	skrl
n.	skrw
n.	skrl
not.	skrl
p.	skrw
p.	skrl
amer.	skrl
arcybp	skrl
adwok.	skrl
afryk.	skrl
akad.	skrl
ang.-amer.	skrl
anonim.	skrl
apost.	skrl
arab.	skrl
asyst.	skrl
azjat.	skrl
aztec.	skrl
babilon.	skrl
baskij.	skrl
chrw.	skrl
chrześc.	skrl
pap.	skrl
płc.	skrl
płd.-wsch.	skrl
pn.-wsch.	skrl
płn.-zach.	skrl
cyb.	skrl
czech.	skrl
ćw.	skrl
dg	skrl
dcg	skrl
d	skrl
dcm	skrl
d	skrl
etrus.	skrl
europ.	skrl
esp.	skrl
fr.	skrl
g.	skrl
grec.	skrl
gw.	skrl
hab.	skrl
holend.	skrl
hucul.	skrl
żoł.	skrl
ż.	skrl
jęz.	skrl
jug.	skrl
kat.	skrl
litew.	skrl
mal.	skrl
mitol.	skrl
młd.	skrl
nieodm.	skrl
nłac.	skrl
ogpol.	skrl
Ossol.	skrw
por.	skrw
progr.	skrl
pr.	skrl
Prz.	skrl
rec.	skrl
reg.	skrl
rep.	skrl
rew.	skrl
rzym.-kat.	skrl
rz.	skrl
s.	skrl
serb.-chorw.	skrl
scen.	skrl
sam.	skrl
sem.	skrl
sen.	skrl
sł.	skrl
słow.	skrl
słoweń.	skrl
sr.	skrl
ss.	skrl
st.	skrl
st.	skrw
szer.	skrl
szwedz.	skrl
szk.	skrl
szk.	skrl
tatar.	skrl
teor.	skrl
turec.	skrl
techn.	skrl
techn.	skrl
tł.	skrl
tłum.	skrl
tryb.	skrl
tys.	skrl
tabl.	skrl
śr.	skrl
śr.	skrl
św.	skrl
śr.	skrl
tel.	skrl
ucz.	skrl
urz.	skrl
war.	skrl
w.	skrl
w.	skrl
w.	skrl
w.	skrl
w.	skrl
wym.	skrl
wyż.	skrw
wyż.	skrl
weter.	skrl
wł.	skrw
wł.	skrl
wł.	skrl
wł.	skrl
woj.	skrl
woj.	skrl
wsp.	skrl
wyd.	skrl
skr.	skrl
wyjąt.	skrl
x.	skrl
zag.	skrl
zak.	skrl
zak.	skrl
zał.	skrw
zam.	skrl
zast.	skrl
zat.	skrl
zaw.	skrl
zast.	skrl
zeg.	skrl
zm.	skrl
zał.	skrl
żyw.	skrl
spec.	skrl
stomat.	skrl
stp.	skrl
zew.	skrl
średw.	skrl
hm.	skrl
p.	skrl
ob.	skrl
mob.	skrl
SP	skrf
portug.	skrl
dst.	skrl
b.u.	skrw
b.z.	skrw
b.z.	skrw
dop.	skrl
bp.	skrw
mkw.	skrl
oprac.	skrw
przekł.	skrl
późn.	skrl
zm.	skrl
Bln.	skrl
a.a.	skrw
aa	skrw
AA	skrl
abec.	skrl
abor.	skrl
absol.	skrl
absol.	skrl
abs.	skrl
absolw.	skrl
abstr.	skrl
abstr.	skrl
żyw.	skrl
a.d.	skrl
ad	skrl
ad.	skrl
adapt.	skrl
adopc.	skrl
adopt.	skrl
adr.	skrl
aero	skrl
aerodyn.	skrl
aerol.	skrl
aeronaut.	skrl
af.	skrl
afro	skrl
ag.	skrl
agit.	skrl
agrot.	skrl
agrotechn.	skrl
agt	skrl
a.j.m.	skrl
akc.	skrl
akkad.	skrl
aklim.	skrl
a.s.c.	skrf
aktual.	skrl
a.n.	skrl
aktyw.	skrl
akt.	skrl
akum.	skrl
akus.	skrl
akust.	skrl
akwar.	skrl
akwat.	skrl
al	skrl
Ala.	skrl
AL	skrl
Alas.	skrl
AK	skrl
Alb.	skrl
aleks.	skrl
alk.	skrl
alkoh.	skrl
alkoh.	skrl
ałt.	skrl
a.m.	skrl
AM	skrl
amat.	skrl
amb.	skrl
anal.	skrl
analit.	skrl
anal.	skrl
anal.	skrl
anal.	skrl
analog.	skrl
anast.	skrl
anat.	skrl
anat.	skrl
anatom.	skrl
Ang.	skrl
ank.	skrl
anon.	skrl
ant.	skrl
ant.	skrl
antioch.	skrl
antyalkohol.	skrl
antyfasz.	skrl
antyfaszyst.	skrl
antykw.	skrl
antys.	skrl
antysem.	skrl
antyst.	skrl
anul.	skrl
berl.	skrl
apt.	skrl
aramej.	skrl
aranż.	skrl
arb.	skrl
archeol.	skrl
arch.	skrl
archidiec.	skrl
arch.	skrl
archip.	skrl
arch.	skrl
archit.	skrl
arch.	skrl
archiw.	skrl
arcydz.	skrl
argent.	skrl
arg.	skrl
AZ	skrl
Ark	skrl
ark.aut.	skrw
ark.druk.	skrw
ark.	skrl
arkt.	skrl
arm.	skrl
arm.	skrl
armat.	skrl
arm.	skrl
arm.	skrl
arm.	skrl
artyl.	skrl
art.	skrl
artyst.	skrl
aryt.	skrl
arytm.	skrl
as.	skrl
asoc.	skrl
ascet.	skrl
asp.	skrl
asrtofiz.	skrl
astronaut.	skrl
astron.	skrl
asym.	skrl
at.	skrl
ata	skrw
atl.	skrl
atl.	skrl
atl.	skrl
atom.	skrl
atm.	skrl
atmosf.	skrl
atmos.	skrl
atram.	skrl
aud.	skrl
aug.	skrl
augs.	skrl
augsb.	skrl
aut.	skrl
autogr.	skrl
aut.	skrl
autom.	skrl
aut.	skrl
autob.	skrl
autobiogr.	skrl
automat.	skrl
autonom.	skrl
a.w.	skrl
aw	skrl
awang.	skrl
awangard.	skrl
azot.	skrl
A-Z	skrl
A-Ż	skrl
bawar.	skrl
b.	skrl
b.	skrl
b.	skrl
b.	skrl
br.	skrl
bież.	skrl
b.a.	skrw
bad.	skrl
bakt.	skrl
bakt.	skrl
bakteriol.	skrl
bal.	skrl
bal.	skrl
bal.	skrl
balet.	skrl
balist.	skrl
bals.	skrl
bałk.	skrl
bałt.	skrl
bar.	skrl
bar.	skrl
b.d.	skrw
b.db.	skrw
bd.	skrw
bart.	skrl
bart.	skrl
baryk.	skrl
baśn.	skrl
baon	skrl
bat.	skrl
bn	skrl
b-n	skrl
batalist.	skrl
baw.	skrl
baweł.	skrl
beletr.	skrl
BE	skrl
BEL	skrl
belgradz.	skrl
bełch.	skrl
ben.	skrl
BM	skrl
BMU	skrl
bern.	skrl
besk.	skrl
bet.	skrl
bezb.	skrl
b.dr.	skrw
b.druk.	skrw
br.k.tyt.	skrw
b.k.tyt.	skrw
b.k.	skrw
bk.	skrw
blm.	skrw
b.m.	skrw
b.m. i r.	skrw
b.m.w.	skrw
b.n.	skrw
b.n. i dr.	skrw
b.w.n.	skrw
b.nap.	skrw
b.n.d.	skrw
b.o.	skrw
b.opr.	skrw
bezp.	skrl
bezp.	skrl
bezpiecz.	skrl
bezpł.	skrl
b.p.	skrw
b.r.	skrw
b.r.w.	skrw
b.s.	skrw
bez st.	skrw
b.t.	skrw
b.w.	skrw
b.wyd.	skrw
b.zm.	skrw
bz.	skrw
bzm.	skrw
błr.	skrl
błrus.	skrl
brs.	skrl
brus.	skrl
białor.	skrl
BLR	skrl
BY	skrl
białost.	skrl
Białyst.	skrl
bibl.	skrl
biblij.	skrl
b-fia	skrl
bibl.	skrl
bibliogr.	skrl
bibliol.	skrl
b-czka	skrl
bibl-czka	skrl
biblka	skrl
b-teczka	skrl
bibliot.	skrl
bibl-ka	skrl
b-ka	skrl
biblt.	skrl
b-teczny	skrl
biec.	skrl
biel.	skrl
BB	skrl
bier.	skrl
bieszcz.	skrl
bil.	skrl
bld	skrl
bln	skrl
bioch.	skrl
biochem.	skrl
c.	skrl
bio	skrl
biogr.	skrl
biogr.	skrl
biol.	skrl
biolog.	skrl
bio	skrl
biom.	skrl
biomet.	skrl
biow.	skrl
biowet.	skrl
bpstwo	skrl
bkob.	skrw
bl.	skrl
bochr.	skrw
boh.	skrl
boj.	skrl
BO	skrl
BOL	skrl
boliw.	skrl
bomb.	skrl
bos.	skrl
bot.	skrl
bosm.	skrl
boż.	skrl
bp	skrw
bpont	skrw
bps	skrw
bramk.	skrl
brat.	skrl
brazyl.	skrl
br.	skrl
brąz.	skrl
brozp	skrw
bda	skrl
b-da	skrl
bryg.	skrl
brzm.	skrl
bs	skrw
bsap	skrw
bsamoch	skrw
bsan	skrw
bsanit	skrw
bstrz	skrw
Bstrz	skrw
bszk.	skrw
bszkol.	skrw
bud.	skrl
budż.	skrl
Bułg.	skrl
BG	skrl
BGR	skrl
burż.	skrl
byd.	skrl
bydg.	skrl
Bydg.	skrl
Byt.	skrl
B-m	skrl
bytom.	skrl
byt.	skrl
bytow.	skrl
b.zw.	skrw
c	skrl
c.	skrl
c.	skrl
c.	skrl
całk.	skrl
c.	skrl
c.	skrl
cięż.	skrl
c.	skrl
cieśn.	skrl
ca	skrl
cetn.	skrl
cntr.	skrl
kal.	skrl
car.	skrl
cejl.	skrl
cel.	skrl
cel.	skrl
cel.	skrl
det.	skrl
c.d.	skrw
c.h.	skrw
hurt.	skrl
c.z.	skrw
c.zb.	skrw
ct.	skrl
ct	skrl
centr.	skrl
cent.	skrl
cent.	skrl
cenz.	skrl
ceram.	skrl
cerk.	skrl
cs.	skrl
ces.	skrl
charakt.	skrl
charyt.	skrl
chem.	skrl
ciek.	skrl
ciśn.	skrl
c.k.	skrl
ck	skrl
daw.	skrl
dec.	skrl
ded.	skrl
dekor.	skrl
dekr.	skrl
del.	skrl
derm.	skrl
did.	skrl
r.	skrl
diec.	skrl
dod.	skrl
dom.	skrl
dom.	skrl
dorz.	skrl
dosł.	skrl
dośw.	skrl
dot.	skrw
dpt.	skrl
druk.	skrl
druż.	skrl
dyn.	skrl
dyn.	skrl
dz.	skrl
eg.	skrl
eksp.	skrl
ekwiw.	skrl
el.	skrl
elektr.	skrl
elem.	skrl
enc.	skrl
epid.	skrl
filh.	skrl
fiz.	skrl
fil.	skrl
flp	skrl
fot.	skrw
foto	skrl
fragm.	skrl
fr.	skrl
gab.	skrl
gastr.	skrl
geol.	skrl
Gg	skrl
giełd.	skrl
gimn.	skrl
gimn.	skrl
gin.	skrl
gł.	skrl
gr.	skrl
gw.	skrl
gwar.	skrl
hig.	skrl
hod.	skrl
hum.	skrl
hum.	skrl
il.	skrw
inf.	skrl
info	skrl
intel.	skrl
intel.	skrl
jaw.	skrl
joń.	skrl
jord.	skrl
jub.	skrl
jubil.	skrl
K	skrl
kt.	skrl
k	skrl
k.	skrl
kan.	skrl
kap.	skrl
kapł.	skrl
kaps.	skrl
kapl.	skrl
kard.	skrl
kat.	skrl
kier.	skrl
kl.	skrl
klima	skrl
klub.	skrl
km	skrl
kod.	skrl
k.c.	skrw
kc.	skrw
kod.cyw.	skrl
kolumb.	skrl
kom.	skrl
komp.	skrl
kompl.	skrl
kpl.	skrl
kplt	skrl
komp	skrl
k	skrl
kop.	skrl
laryng.	skrl
likw.	skrl
liturg.	skrl
luks.	skrl
m.b.	skrl
monogr.	skrl
obs.	skrl
odb.	skrl
odl.	skrl
orz.lek.	skrl
os.	skrl
ośr.	skrl
ośw.	skrl
ozn.	skrl
P	skrl
poj.	skrl
pow.	skrl
prob.	skrl
prod.	skrl
proj.	skrl
publ.	skrl
publ.	skrl
pyt.	skrl
rad.	skrl
ref.	skrl
ref.	skrl
rej.	skrl
rekl.	skrl
ret.	skrl
rez.	skrl
rez.	skrl
rol.	skrl
roln.	skrl
rozw.	skrl
RUR	skrl
sam	skrl
S.C.	skrw
ST	skrf
scs	skrl
sem.	skrl
ser.	skrl
s-ka	skrl
spr.	skrl
Stow.	skrl
subst.	skrl
syg.	skrl
sygn.	skrl
symb.	skrl
szczeg.	skrl
tem.	skrl
Tow.	skrl
tur.	skrl
ubezp.	skrl
U.	skrl
ust.	skrl
utw.	skrl
użyt.	skrl
wt.	skrl
wzgl.	skrl
zam.	skrl
zca	skrl
zw.	skrl
zwr.	skrl
żegl.	skrl
żel.	skrl
d/s	skrw
w/g	skrw
kom.	skrl
pt	skrl
pon.	skrl
ww.	skrf
Dz.	skrl
DzU	skrw
n.-gr.	skrl
n.-łac.	skrl
N.T.	skrl
Ko	skrw
Pt	skrw
ang.	skrl
abpstwo	skrl
R.P.	skrw
JWP	skrf
PNM	skrf
Sz.	skrl
W.	skrl
kol.	skrl
JWP	skrf
EUR	skrl
nzw.	skrl
ws.	skrw
r.ub.	skrw
rb.	skrw
ub.r.	skrw
Mł.	skrl
d-ca	skrs
akc.	skrl
B.	skrw
bezok.	skrl
C.	skrw
cz.	skrl
czas.	skrl
D.	skrw
dca	skrl
dekl.	skrl
dial.	skrl
dop.	skrl
fon.	skrl
fonol.	skrl
fraz.	skrl
Hz	skrl
im.	skrl
koniug.	skrl
licz.	skrl
M.	skrw
m.os.	skrl
Msc.	skrw
najw.	skrl
nieos.	skrl
nieprzech.	skrl
odm.	skrl
onk.	skrl
ort.	skrl
orz.	skrl
podm.	skrl
pot.	skrl
przech.	skrl
przen.	skrl
przyd.	skrl
przyim.	skrl
przym.	skrl
przyr.	skrl
radiol.	skrl
r.m.	skrl
r.n.	skrl
rozk.	skrl
RŚ	skrw
rtg.	skrl
rzecz.	skrl
r.ż.	skrl
samogł.	skrl
satyr.	skrl
SJPS	skrl
spółgł.	skrl
tr.	skrl
W.	skrw
WXL	skrf
wyż.	skrl
zd.	skrl
zdr.	skrl
żarg.	skrl
b	skrl
B	skrl
kB	skrl
kw.	skrl
m.	skrl
N.	skrw
nieżyw.	skrl
NSO	skrl
obelż.	skrl
partyk.	skrl
podn.	skrl
pogard.	skrl
przest.	skrl
rub.	skrl
skr.	skrl
SOJP	skrl
sp.	skrl
zgr.	skrl
antr.	skrl
antol.	skrl
kecz.	skrl
sanskr.	skrl
amh.	skrl
l.	skrl
lm	skrw
GB	skrl
MB	skrl
kG	skrl
kWh	skrl
kW	skrl
kcal	skrl
lm.	skrf
blm	skrw
blp	skrw
kHz	skrl
lp.	skrf
dk	skrl
BZ	skrw
j.	skrl
m.	skrl
n.	skrl
part.	skrl
Ms.	skrw
czasow.	skrl
fonet.	skrl
antrop.	skrl
antropol.	skrl
dag	skrl
liczeb.	skrl
przysł.	skrl
st.	skrl
w.	skrl
wyr.	skrl
WXLit	skrf
W.Ks.Lit.	skrf
sat.	skrl
MB	skrf
A	skrl
a.	skrl
acet.	skrl
acetyl.	skrl
aerob	skrl
af.	skrl
agl.	skrl
aglut.	skrl
akg.	skrl
akom.	skrl
akomp.	skrl
akord.	skrl
akrob.	skrl
Ala	skrl
Alb.	skrl
alg.	skrl
alopl.	skrl
am.	skrl
amp.	skrl
amp.	skrl
As.	skrl
Ah.	skrl
anam.	skrl
anamn.	skrl
anm.	skrl
anim.	skrl
anim.	skrl
ant.	skrl
apl.	skrl
Ar	skrl
Atl.	skrl
atm	skrl
Azw.	skrl
b	skrl
b	skrl
B	skrl
b.	skrl
baln.	skrl
balneol.	skrl
bat.	skrl
b.d.	skrw
blp.	skrw
b.sygn.	skrw
Bg	skrl
bier.	skrw
br.	skrl
br.	skrl
brosz.	skrl
C.	skrl
cel.	skrl
mian.	skrw
chir.	skrl
ch.	skrl
chor.	skrl
d-ca	skrl
J	skrl
J.	skrl
komp.	skrl
k	skrl
lg	skrl
log	skrl
cerk.-słow.	skrl
m	skrl
N.	skrl
N	skrl
Pa	skrl
pd.	skrl
r.	skrl
rz.	skrl
suf.	skrl
pref.	skrl
t	skrl
Tab	skrw
s.	skrl
t.	skrl
dop.	skrw
narz.	skrw
os.	skrl
XBW	skrl
MSG	skrw
NA	skrw
N/A	skrw
M-me	skrl
Lam	skrw
Ltd.	skrw
Corp.	skrl
Co.	skrl
dB	skrl
OK	skrw
s.f.	skrw
WW	skrl
CC	skrw
IO	skrw
MD	skrl
m/y	skrw
n/s	skrw
SC	skrl
s/y	skrw
jr.	skrl
x.	skrw
ESC	skrw
CD	skrw
tlx	skrw
ccm	skrl
m/s	skrw
s/s	skrw
k.o.	skrw
m.	skrl
repr.	skrl
abbr.	skrl
abbrev.	skrl
abr.	skrl
abt.	skrl
agr.	skrl
alc.	skrl
Am.	skrl
Ariz.	skrl
Aug.	skrl
bkt.	skrl
bsk	skrl
car.	skrl
ct.	skrl
ct	skrl
Dec.	skrl
del.	skrl
dep.	skrl
dev.	skrl
dig.	skrl
e-mail	skrl
f.e.	skrw
Feb.	skrl
lang.	skrl
Mrs	skrl
Mr	skrl
PC	skrl
pop	skrl
rec.	skrw
SF	skrw
str.	skrl
transl.	skrl
ABT	skrw
AFAR	skrw
AFK	skrw
AFS	skrw
AI	skrw
ASAP	skrw
ASL	skrw
ATB	skrw
ATM	skrw
AWA	skrw
B	skrw
B/C	skrw
BAK	skrw
BBL	skrw
BBS	skrw
BC	skrw
BOC	skrw
BOT	skrw
BTU	skrw
BTW	skrw
CBL	skrw
CU	skrw
CUL	skrw
FAQ	skrw
FAS	skrw
FAW	skrw
FTF	skrw
GBH	skrw
GL	skrw
HB	skrw
HF	skrw
HMP	skrw
HORU	skrw
IC	skrw
IDK	skrw
IMO	skrw
JAM	skrw
JK	skrw
J/K	skrw
K	skrw
LAY	skrw
LOL	skrw
LY	skrw
MOF	skrw
NC	skrw
N-Joy	skrw
NP.	skrw
N/P	skrw
PLS	skrw
QL	skrw
RGDS	skrw
ROTFL	skrw
RUOK	skrw
SS	skrw
TBH	skrw
THX	skrw
U	skrw
UR	skrw
WU	skrw
Ctrl	skrw
Del	skrw
Esc	skrw
PgUp	skrw
PgDn	skrw
dan	skrl
aranż	skrl
cg	skrl
cG	skrl
cl	skrl
cl.	skrl
dg.	skrl
dgn.	skrl
acc.	skrw
a.t.	skrw
coff.	skrw
cos	skrw
ctg	skrw
dat.	skrw
e.g.	skrw
fin.	skrw
fut.	skrw
G.	skrw
id.	skrw
imp.	skrl
imperf.	skrl
ind.	skrl
INRI	skrf
loc.	skrw
max.	skrl
nom.	skrw
op.cit.	skrw
p.Ch.n.	skrw
pf.	skrw
pl.t.	skrw
plur.	skrw
R.I.P.	skrw
tg	skrw
v.	skrw
voc.	skrw
abl.	skrw
A.D.	skrw
adi.	skrw
adv.	skrw
f.	skrw
IHS	skrw
INC	skrw
IND	skrw
sing.	skrw
ib.	skrw
nb.	skrw
c.	skrw
h.c.	skrw
inc.	skrw
arc.	skrl
etc.	skrw
Inf.	skrl
vol.	skrw
N.N.	skrw
op.	skrw
a.Chr.	skrw
ps.	skrw
P.T.	skrw
inst.	skrw
Tb	skrl
cal	skrl
sin	skrw
h	skrl
ibid.	skrw
jun.	skrl
s.	skrl
ss.	skrw
ss.	skrw
aber.	skrl
aberr.	skrl
abol.	skrl
abs.	skrl
absol.	skrl
absol.	skrl
absolut.	skrl
absolut.	skrl
adn.	skrl
adnot.	skrl
Al	skrl
al.	skrl
aluz.	skrl
amp.	skrl
an.	skrl
ann.	skrl
annal.	skrl
Au	skrl
cal.	skrl
Cal.	skrl
con.	skrl
cot	skrl
dat.	skrl
d.d.	skrw
dem.	skrl
ed.maj.	skrw
ed.min.	skrw
mol.	skrl
max	skrl
mxm	skrl
pas.	skrl
pass.	skrl
sec.	skrl
sig.	skrl
vs	skrw
PS	skrw
Dat.	skrw
N.	skrw
gen.	skrw
D.	skrw
I.	skrw
L.	skrw
V.	skrw
ca	skrw
sen.	skrl
sr.	skrl
ekg.	skrl
atd.	skrw
atp.	skrw
A.	skrw
astron.	skrl
anim.	skrl
a.	skrl
A	skrl
adm.	skrl
adm.	skrl
ak.	skrl
ak.	skrl
al.	skrl
am.	skrl
ang.	skrl
anon.	skrl
arch.	skrl
arg.	skrl
art.	skrl
art.	skrl
art.	skrl
at.	skrl
b.	skrl
bar.	skrl
bart.	skrl
bibl.	skrl
biogr.	skrl
byt.	skrl
centr.	skrl
chor.	skrl
dz.	skrl
fen.	skrl
fil.	skrl
gł.	skrl
got.	skrl
in.	skrl
j.	skrl
kal.	skrl
kom.	skrl
księg.	skrl
kwart.	skrl
lek.	skrl
m	skrl
Mt	skrw
p.	skrl
rep.	skrl
scen.	skrl
spec.	skrl
św.	skrl
t.	skrl
tow.	skrl
tow.	skrl
zm.	skrw
